上条当麻	shang tiao dang ma	1
土御门元春	 tu yu men yuan chun	1
姬神秋沙	ji shen qiu sha	1
吹寄制理	chui ji zhi li	1
云川芹亚	yun chuan qin ya	1
月咏小萌	yue yong xiao meng	1
黄泉川爱穗	huang quan chuan ai sui	1
亲船素甘	qin chuan su gan	1
御坂美琴	yu ban mei qin	1
白井黑子	bai jing hei zi	1
婚后光子	hun hou guang zi	1
泡浮万彬	pao fu wan bin	1
切斑芽美	qie ban ya mei	1
蜜蚁爱愉	mi yi ai yu	1
弓箭入鹿	gong jian ru lu	1
北条彩铃	bei tiao cai ling	1
薄绢休味	bo juan xiu wei	1
食蜂操祈	shi feng cao qi	1
帆风润子	fan feng run zi	1
口囃子早鸟	kou ca zi zao niao	1
初春饰利	chu chun shi li	1
佐天泪子	zuo tian lei zi	1 
春上衿衣	chun shang jin yi	1
枝先绊理	zhi xian ban li	1
樱坂风雅	ying ban feng ya	1
一方通行	yi fang tong xing	1
铃科百合子	ling ke bai he zi	1
布束砥信	bu shu di xin	1
相园美央	xiang yuan mei yang	 1
风斩冰华	feng zhan bing hua	1
结标淡希	jie biao dan xi	1
警策看取	jing ce kan qu	1
土御门舞夏	tu yu men wu xia	1
云川鞠亚	yun chuan ju ya	1
芙蕾梅亚赛维纶	fu lei mei ya sai wei lun	10
海原光贵	hai yuan guang gui	1
微细乙爱	wei xi yi ai	 1
重福省帆	chong fu sheng fan	1
柊元响季	zhong yuan xiang ji	1
原谷矢文	yuan gu shi wen	1
介旅初矢	jie lv chu shi	1
操齿凉子	cao chi liang zi	1
化生院明日香	hua sheng yuan ming ri xiang	1
鸿野江遥希	hong ye jiang yao xi	 1
美山写影	mei shan xie ying	1
舞殿星见	wu dian xing jian	1
固法美伟	gu fa mei wei	1
柳破碧美	liu po bi mei	1
铁装缀里	tie zhuang zhui li	1
爱札力  ai zha li	1
垣根帝督	yuan gen di du	1
狱彩海美	yu cai hai mei	1
誉望万化	yu wang wan hua	1
砂皿致密	sha min zhi mi	1
马场芳郎	ma chang fang lang	1
索绮特	suo qi te	1
查乐	cha le	1
警策看取	jing ce kan qu	1
麦野沉利	mai ye chen li	1
绢旗最爱	juan qi zui ai	1
芙兰达	fu lan da	1
赛维纶	sai wei lun	1
泷壶理后	long hu li hou		1
浜面士上	bang mian shi shang	1